+-+-+-+-+-+-+-+-+-+-+
S |         | |     |
+ +-+-+-+-+ + + + +-+
|   | |     |   |   |
+-+ + + +-+-+-+-+ + +
|   |   |     | | | |
+ +-+ +-+ +-+ + + +-+
| |     |   | | |   |
+ + +-+-+-+ + + +-+ +
| |   |   | |   |   |
+ + + + + + +-+ + +-+
|   | | |   | | |   |
+-+-+ + +-+-+ + + + +
|     |     |   | | |
+ +-+-+ +-+-+-+-+ + +
| |   | |       | | |
+ +-+ + + +-+-+ + + +
|       | | |   | | |
+-+ + +-+ + + +-+ + +
|   |     |       | E
+-+-+-+-+-+-+-+-+-+-+